PLAYER-START
SANITY :100
CREDIT-POINTS :15
TOWER-ENTRY :1
TOWER-ENTRY :2
TOWER-ENTRY :3
TOWER-ENTRY :4
TOWER-ENTRY :5
PLAYER-END
MAP-START
WIDTH :12
HEIGHT:12
ARRAY :
ROW 0;0; 0; 1; 0; 0; 0; 0; 0; 0; 1; 0; 0; 
ROW 1;3; 3; 0; 0; 0; 0; 0; 0; 0; 0; 3; 3; 
ROW 2;4; 4; 0; 0; 0; 1; 1; 0; 0; 0; 4; 4; 
ROW 3;3; 3; 0; 0; 4; 4; 4; 4; 0; 0; 3; 3; 
ROW 4;4; 4; 0; 0; 4; 4; 4; 4; 0; 0; 4; 4; 
ROW 5;3; 3; 0; 0; 4; 4; 4; 4; 0; 0; 3; 3; 
ROW 6;4; 4; 0; 0; 4; 4; 4; 4; 0; 0; 4; 4; 
ROW 7;3; 3; 0; 0; 4; 4; 4; 4; 0; 0; 3; 3; 
ROW 8;4; 4; 0; 0; 0; 0; 0; 0; 0; 0; 4; 4; 
ROW 9;0; 0; 0; 0; 0; 0; 0; 0; 0; 0; 0; 0; 
ROW 10;0; 0; 0; 0; 0; 0; 0; 0; 0; 0; 0; 0; 
ROW 11;0; 0; 2; 0; 0; 0; 0; 0; 0; 0; 0; 0; 
MAP-END
WAVES-START
WAVES-END
