PLAYER-START
SANITY :10
CREDIT-POINTS :10
TOWER-ENTRY :1
TOWER-ENTRY :2
TOWER-ENTRY :3
TOWER-ENTRY :4
TOWER-ENTRY :5
PLAYER-END
MAP-START
WIDTH :16
HEIGHT:8
ARRAY :
ROW 0;1; 0; 0; 0; 0; 0; 0; 0; 0; 0; 0; 0; 0; 3; 0; 0; 
ROW 1;0; 0; 0; 3; 0; 5; 0; 3; 0; 5; 0; 3; 0; 5; 0; 0; 
ROW 2;0; 0; 0; 3; 0; 3; 0; 3; 0; 3; 0; 3; 0; 3; 0; 0; 
ROW 3;0; 0; 0; 0; 0; 3; 0; 0; 0; 3; 0; 0; 0; 3; 0; 2; 
ROW 4;0; 0; 0; 3; 0; 0; 0; 3; 0; 0; 0; 3; 0; 0; 0; 0; 
ROW 5;0; 0; 0; 3; 0; 3; 0; 3; 0; 3; 0; 3; 0; 3; 0; 0; 
ROW 6;0; 0; 0; 5; 0; 3; 0; 5; 0; 3; 0; 5; 0; 3; 0; 0; 
ROW 7;1; 0; 0; 0; 0; 0; 0; 0; 0; 0; 0; 0; 0; 0; 0; 0; 
MAP-END
WAVES-START
WAVES-END
