PLAYER-START
SANITY :10
CREDIT-POINTS :10
TOWER-ENTRY :1
TOWER-ENTRY :2
TOWER-ENTRY :3
PLAYER-END
MAP-START
WIDTH :16
HEIGHT:8
ARRAY :
ROW 0;1; 0; 0; 0; 0; 0; 0; 0; 0; 0; 0; 0; 0; 0; 0; 0; 
ROW 1;1; 0; 0; 3; 0; 5; 0; 3; 0; 5; 0; 3; 0; 5; 0; 0; 
ROW 2;1; 0; 0; 3; 0; 3; 0; 3; 0; 3; 0; 3; 0; 3; 0; 0; 
ROW 3;1; 0; 0; 0; 0; 3; 0; 0; 0; 3; 0; 0; 0; 3; 0; 2; 
ROW 4;1; 0; 0; 3; 0; 0; 0; 3; 0; 0; 0; 3; 0; 0; 0; 0; 
ROW 5;1; 0; 0; 3; 0; 3; 0; 3; 0; 3; 0; 3; 0; 3; 0; 0; 
ROW 6;1; 0; 0; 5; 0; 3; 0; 5; 0; 3; 0; 5; 0; 3; 0; 0; 
ROW 7;1; 0; 0; 0; 0; 0; 0; 0; 0; 0; 0; 0; 0; 0; 0; 0; 
MAP-END
WAVES-START
WAVES-END
