WIDTH :16
HEIGHT:8
ARRAY :
ROW 0;1; 0; 0; 0; 0; 0; 0; 0; 0; 0; 0; 0; 0; 0; 0; 0; 
ROW 1;0; 0; 0; 0; 0; 0; 0; 2; 2; 0; 0; 0; 0; 0; 0; 0; 
ROW 2;0; 0; 0; 0; 0; 0; 2; 2; 2; 2; 0; 0; 0; 0; 0; 0; 
ROW 3;0; 0; 0; 0; 0; 2; 0; 0; 0; 0; 2; 0; 0; 0; 0; 0; 
ROW 4;0; 0; 0; 0; 0; 2; 0; 0; 0; 2; 2; 0; 0; 0; 0; 2; 
ROW 5;0; 0; 0; 0; 0; 0; 2; 0; 2; 2; 0; 0; 0; 0; 0; 0; 
ROW 6;0; 0; 0; 0; 0; 0; 2; 2; 2; 0; 0; 0; 0; 0; 0; 0; 
ROW 7;0; 0; 0; 0; 0; 0; 0; 0; 0; 0; 0; 0; 0; 0; 0; 0; 
