PLAYER-START
SANITY :100
CREDIT-POINTS :15
PLAYER-END
MAP-START
WIDTH :16
HEIGHT:8
ARRAY :
ROW 0;0; 3; 0; 0; 0; 0; 0; 0; 0; 1; 0; 0; 0; 0; 0; 0; 
ROW 1;3; 3; 3; 3; 0; 0; 3; 3; 3; 3; 3; 3; 3; 0; 0; 0; 
ROW 2;3; 3; 0; 3; 0; 0; 0; 0; 0; 0; 0; 0; 0; 3; 0; 0; 
ROW 3;0; 0; 0; 3; 0; 0; 0; 0; 0; 0; 3; 3; 3; 3; 0; 0; 
ROW 4;0; 0; 0; 3; 3; 3; 3; 3; 3; 3; 0; 0; 0; 0; 0; 0; 
ROW 5;0; 0; 0; 0; 0; 0; 3; 0; 0; 0; 0; 0; 0; 0; 0; 0; 
ROW 6;0; 2; 0; 0; 0; 0; 3; 3; 0; 0; 0; 0; 0; 0; 0; 0; 
ROW 7;0; 0; 0; 0; 0; 0; 0; 0; 0; 0; 0; 0; 0; 0; 0; 0; 
MAP-END
WAVES-START
WAVES-END
